10 15
###############
#             #
# # ##### # # #
# # *   # # # #
# # # # #     #
# ##### ## ####
#   ### #    ##
# #   #    # ##
# # #   # ##  $
###############